CommitID, Committer, FilesChanged, LinesChanges, LinesAdded, LinesDeleted
34c37e0f6ebe4f5505f2ea91aaeb232d162c11d4, OpsMx, 5, 193, 144, 49
408b915da68e7c0d5998fbe9ded0e561a2ff5346, SheetalAtre, 3, 58, 48, 10
470685fd333a24e4d751a646683978402f27ae1a, SheetalAtre, 1, 2, 1, 1
4b80bc438d03a9a2188612199166d5e5ba78a9c7, yugaa22, 1, 19, 0, 19
50a3c29184871c74d6c47528b278d72b2d5538d6, SheetalAtre, 1, 17, 15, 2
5fe11ba2e4f8c851b1d0916cb21e84eb5b7cbc9b, GitHub, 1, 1, 1, 0
6931a63a6c76c641a17832d2d2a09fc2b34628ae, yugaa22, 3, 58, 48, 10
6bbcb78b21a7d8767026de4401841832d18a90bd, yugaa22, 4, 63, 54, 9
706aa525ccb4589ed31ac4e61a2a73606e945bca, SheetalAtre, 2, 116, 65, 51
758d4a4054c715e6fe9cd889b69d8639d49d4a88, SheetalAtre, 4, 63, 54, 9
ae5504978e2d7c6f6e9e8b6b4bb90f3448d7dfc0, yugaa22, 2, 232, 229, 3
cb3715c19dc6bb0b55a0a2051af9b1cd5fd31fdb, GitHub, 1, 2, 1, 1
e9ffb285ff2c4a1907c9cddf1ac52e7ace320894, SheetalAtre, 1, 19, 0, 19
