CommitID, Committer, FilesChanged, LinesChanges, LinesAdded, LinesDeleted
2c4ab661a17f9563e15264c1d787aaab39696e3a, rahul-chekuri, 1, 35, 34, 1
3da9940b89f837c1d49865802794ac449a81a025, rahul-chekuri, 1, 1, 1, 0
698d84f68a0037c566b2327410d7cbd5d8350d51, sudhakaropsmx, 1, 4, 2, 2
b1cc00118f8fa38d91e00333624a1a6d8ea0cdba, sudhakaropsmx, 4, 11, 6, 5
b2a54f14b63a5633becd819187a684d09c7d4fd4, rahul-chekuri, 1, 1, 1, 0
bdbc0c408df7010c598b4d55a3ed2b2205f3a335, sudhakaropsmx, 2, 52, 23, 29
ce59502071922789bec44e13ead312d88aefbdc5, rahul-chekuri, 1, 8, 4, 4
dae80dc1abbba071d798c5cfe15d6531579af36d, sudhakaropsmx, 1, 16, 9, 7
e78ea2890da1bc7e257046fdacde9161c9265c66, yugaa22, 1, 1, 1, 0
f1459a027d008d21a80ab47e1b4a8227b8e38d81, yugaa22, 4, 12, 7, 5
f46e3e7e73a62ef0f5aaa0f9c82a68dc14c1f655, sudhakaropsmx, 1, 1, 1, 0
